team,match,win,loss,draw,score
G-2,11,8,3,0,24
G-14,11,7,4,0,21
G-1,8,7,1,0,21
G-11,11,6,5,0,18
G-9,10,5,5,0,15
G-8,8,5,3,0,15
G-12,6,4,2,0,12
G-3,6,4,2,0,12
G-10,6,4,2,0,12
G-7,6,3,3,0,9
G-5,5,2,3,0,6
G-4,5,2,3,0,6
G-15,7,2,5,0,6
G-6,11,2,9,0,6
G-13,8,1,7,0,3
G-16,5,0,5,0,0
