team,match,win,loss,draw,score
G-2,11,8,3,0,24
G-1,9,8,1,0,24
G-14,11,7,4,0,21
G-11,12,6,6,0,18
G-12,9,6,3,0,18
G-9,10,5,5,0,15
G-8,9,5,4,0,15
G-10,7,5,2,0,15
G-3,9,5,4,0,15
G-7,6,3,3,0,9
G-5,6,3,3,0,9
G-4,5,2,3,0,6
G-15,7,2,5,0,6
G-6,14,2,12,0,6
G-13,10,2,8,0,6
G-16,7,2,5,0,6
