team,match,win,loss,draw,score
G-1,6,6,0,0,18
G-11,9,6,3,0,18
G-12,6,4,2,0,12
G-14,7,4,3,0,12
G-9,9,4,5,0,12
G-3,4,3,1,0,9
G-7,5,3,2,0,9
G-8,6,3,3,0,9
G-5,5,2,3,0,6
G-10,3,2,1,0,6
G-4,3,2,1,0,6
G-2,4,2,2,0,6
G-6,9,1,8,0,3
G-13,4,1,3,0,3
G-15,4,0,4,0,0
G-16,2,0,2,0,0
